################################
#   #. #.#.#       #     #.#.#3#
# # ##       ##  #   ###   #.#1#
# # #. # ###    #### .#..# # # #
# # ## # ..# #   #   ##### # # #
# #    ##### ###   ###.#   # # #
# ## # ..#.  #.###       #   # #
# #. ##.####        #.####  ## #
# ##  ####.#        ####.## .# #
# #   #       ###.#  .#.. # ## #
# # #   #.###   ### #####    # #
# # # #####   #   # #.. # ## # #
# # # #..#. ####    ### # .# # #
#0#.#   ###   #  ##       ## # #
#2#.#.#     #       #.#.# .#   #
################################
